NO ./textures/north.xpm
SO ./textures/south.xpm
WE ./textures/west.xpm
EA ./textures/east.xpm

F 100,100,100
C 200,200,255

111111111111
10001   1001
10001   1001
10W011111001
100000000001
111111111111

