NO ./textures/north.xpm
SO ./textures/south.xpm
EA ./textures/east.xpm
WE ./textures/west.xpm
C 51,0,51
F 25,51,0

1111111111111111111111
1000000000000000000001
1000000000100000000001
1000000000100000000001
1000000111111100000001
1000000000000000000001
1000000000S00000000001
1000000000000000000001
1000000000000000000001
1111111111111111111111
